xxxxxxxxxxxxxxxxx
xv....L....L....x
x...............x
xv..............x
x..L....L....L..x
x...............x
xv....LLLLL.....x
x...............x
xv..............x
x..L....8...L...x
x...............x
xv....L...L.....x
x...............x
xv..............x
x..L....LLLLL...x
x...............x
xv....L....L....x
x.......P.......x
x...............x
xxxxxxdddxxxxxxxx