xxxxxxxuuuxxxxxxx
x...............x
x...............x
x...............x
x....xx....xx...x
x....x......x...x
x...............x
x.......8.......x
x...............x
x...............x
x...............x
xxxxx........xxxx
x...............x
x...............x
x...............x
x.....x...x.....x
x..xxxx...xxxx..x
x...............x
x...............x
xxxxxxxdddxxxxxxx