xxxxxuuxxxxx
xxx......xxx
xxx......xxx
xxx......xxx
xxx...H..xxx
lll......xxx
lll......xxx
xxx......xxx
xxx......xxx
xxx......xxx
xxxQQQQQQxxx
xxxxxxxxxxxx