xxxxxuuxxxxx
xxxL.....Lxx
xxxL.....xxx
xxxL.....xxx
xxxLS....xxx
xxxL.....rrr
xxxL.....rrr
xxxL.....rrr
xxxL.....xxx
xxxL....Lxxx
xxxLLLLLLxxx
xxxxxxxxxxxx