xxxx.u..xxxx
Lxx......xLx
xLx......Lxx
xxL......Lxx
xLx..F...xLx
xxL......xLx
xxL......Lxx
xLx......Lxx
Lxx......xLx
xLx......xLx
xxL......Lxx
xLxLLddxxxxx