xxxx.u..xxxx
Lxx......xLx
xLv......Lxx
xxL......Lxx
xLv......xLx
xxL......xLx
xxv......Lxx
xLx......Lxx
Lxv......xLx
xLx......xLx
xxv......Lxx
xLxLLddxxxxx