Lxxx.u..xxxx
xLx......xLx
Lxv......Lxx
xLx......Lxx
Lxv......xLx
xxx......xLx
Lxv......Lxx
xLx......Lxx
Lxv......xLx
xLx......xLx
Lxv......Lxx
xLxLLddxxxxx