xxxLLLLLLxxx
xxx......xxx
xxx......xxx
xxx..G...xxx
xxx......xxx
xxx......xxx
xxx......xxx
xxx......xxx
xxx......xxx
xxx......xxx
xxx......xxx
xxxxxddxxxxx