xxxLLLLLLxxx
xxxLLLLLLxxx
xxxLLLLLLxxx
xxx......xxx
xxx..g...xxx
xxx......rrr
xxx......rrr
xxx......xxx
xxx......xxx
xxx......xxx
xxx......xxx
xxxxxddxxxxx