xxxxxLLxxxxx
xxxxLLLLxxxx
xxxLxLLxLxxx
xLLxxLLxxLLx
............
............
......N.....
............
xxLLLxxLLLxx
xxxLxLLxLxxL
xxxxLLLLxxxx
xxxxxLLxxxxx