xxxxxuuxxxxx
x....x.....x
x.xx.x.xxx.x
L..x.x...x.L
L..x.xxx.x.L
L....x...x.r
L.xxx.x.xxxr
L.x...x....x
x.x.xxxxx..x
x...x......x
x..K.......x
xxxxxxxxxxxx