xxxxxxxxxxxx
x.....x...xx
x.xxx.x.x..x
x.x...x.x..x
x.x.xxx.xx.x
..x........x
..xxx.xxx..x
....x...x..x
x...x...x..x
xxxxx...x..x
x.....xxx.ax
xxxxxddxxxxx