xxxxxLLxxxxx
xxxxLLLLxxxx
xxxLxLLxLxxx
xxLLLLLLLLxx
............
............
......i.....
............
xxLLLLLLLLxx
xxxLxLLxLxxL
xxxxLLLLxxxx
xxxxxLLxxxxx