xxxxxuuxxxxx
xL.........x
xL.........x
xL.........x
xL...b.....x
xL.........r
xL.........r
xL.........r
xL.........x
xL.........x
xLLLLLLLLLLx
xxxxxxxxxxxx