xxxxxxxxxxxx
LLLLLL.LLLLx
LLLLLL....Ax
LLLLLL.LLLLx
.......LLLLx
LLLLLL.LLLLx
LLLLLL.LLLLx
.......LLLLx
.......LLLLx
LLLLL..LLLLx
LLLLL..LLLLx
xxxxxddxxxxx