xxxxxxxuuuxxxxxxx
x...x...x...x...x
x.......x.x.xx..x
xx..x...x......xx
xxx.xxx.e.xx..xxx
x...x.......x...x
x.x...........x.x
x.x...........x.x
x.....xxxxx...x.x
x....x.....x....x
x....x..Z..x....x
x.....xx.xx.....x
x.x...........x.x
x.x...........x.x
x.xx.........xx.x
x...x.......x...x
x.. x.......x...x
x...x.......x...x
x...............x
xxxxxxxdddxxxxxxx