xxxxxxxuuuxxxxxxx
x...x...x...x...x
x..xx.x.x.x.xx..x
xx.xx...x...xx.xx
xxx.xxx.e.xxx.xxx
x...x..x.x..x...x
x.x..x.....x..x.x
x.x..x.....x..x.x
x.xx..xxxxx..xx.x
x....x.....x....x
x.x..x..Z..x..x.x
x..x..xx.xx..x..x
x.x..x.....x..x.x
x.x..x..x..x..x.x
x.xx.x.....x.xx.x
x...x.xxx.xxx...x
x..xx...x...xx..x
x...x...x...x...x
x...............x
xxxxxxxdddxxxxxxx