xxxxxxxuuuxxxxxxx
x...x...x...x...x
x...x.x.x.x.x...x
xx.xx...x...xx.xx
xxx.xxx...xxx.xxx
x...x.........x.x
x.x.....4.....x.x
x.x...........x.x
x.x...........x.x
x...............x
x.x...........x.x
x..x.........x..x
x.x...........x.x
x.x...........x.x
x.x.x.......x.x.x
x...x.xxx.xxx...x
x...x...x...x...x
x...............x
xxxxxxxdddxxxxxxx