xxxxxxxuuuxxxxxxx
x...............x
x...............x
x.....xxxxx.....x
x..G..x...x.....x
x.....x.e.x.....x
x.....x...x.....x
x.....x...x.....x
x...............x
xxx...........xxx
x...............x
xv..............x
x...............x
x...............x
x...xxx...xxx...x
x...x.......x...x
x...x.......x...x
xv..............x
x...............x
xxxxxxxdddxxxxxxx