xxxxxxxuuuxxxxxxx
x...x...x...x...x
x..xx.x.x.x.xx..x
xx.xx...x...xx.xx
xxx.xxx...xxx.xxx
x.e.x..x.x..x.e.x
x.x..x..e..x..x.x
x.x..x.....x..x.x
x.xx..x...x..xx.x
x....x.....x....x
x.x..x..x..x..x.x
x..x..x...x..x..x
x.x..x.....x..x.x
x.x..x..x..x..x.x
x.xx.x.....x.xx.x
x...x.xxx.xxx...x
x..xx...x...xx..x
x...x...x...x...x
x...............x
xxxxxxxdddxxxxxxx